8 8 8 8 8 8 8 8 8 8 8 8 8 8 8 
8 8 8 8 8 8 8 8 8 8 8 8 8 8 8 
8 8 8 8 8 8 8 8 8 8 8 8 8 8 8 
8 8 8 8 8 8 8 8 8 8 8 8 8 8 8 
8 8 8 8 9 9 9 9 9 8 8 8 8 8 8 
8 8 8 8 9 9 9 9 9 8 8 8 8 8 8 
8 8 8 8 9 9 9 9 9 8 8 8 8 8 8 
8 8 8 8 9 9 9 9 9 8 8 8 8 8 8 
8 8 8 8 9 9 9 9 9 8 8 8 8 8 8 
8 8 8 8 9 9 9 9 11 8 8 8 9 10 9 
8 8 8 8 9 9 9 9 9 8 8 8 9 10 9 
8 8 8 8 9 9 9 9 9 8 8 8 9 10 9 
8 8 8 8 9 9 9 9 9 8 8 8 9 10 9 
8 8 8 8 9 9 9 9 9 8 8 8 9 10 9 
8 8 8 8 9 9 9 9 9 8 8 8 9 10 9 

82 0 0 0 0 0 42 0 0 0 0 0 0 0 0 
2 0 0 0 0 0 2 2 2 2 2 2 2 2 41 
74 2 0 0 0 0 0 0 0 69 0 70 0 2 2 
0 0 2 0 0 0 0 83 0 0 0 0 0 0 78 
0 0 0 2 2 2 2 2 2 1 2 2 2 2 2 
0 0 83 0 0 0 83 0 0 0 83 0 0 0 83 
2 2 2 1 2 2 2 2 2 2 2 2 2 2 2 
9 0 0 0 0 0 0 0 10 0 0 86 0 0 0 
2 2 2 2 2 2 2 2 2 2 2 13 2 2 2 
0 0 0 0 0 0 0 0 0 0 0 14 0 0 71 
0 3 0 0 2 45 45 45 2 0 0 12 0 0 0 
0 5 0 0 20 11 67 11 2 0 0 3 0 0 0 
0 4 0 0 2 2 0 2 2 0 0 4 0 0 0 
85 5 0 0 0 0 0 0 0 0 81 4 0 0 0 
43 4 6 7 7 7 7 7 7 7 8 5 2 41 2 
