1 1 2 2 2 3 3 3 3 2 2 2 2 1 1 
1 2 2 2 2 2 3 3 3 3 2 2 1 1 1 
1 1 2 2 2 3 5 3 3 2 2 2 2 1 1 
1 2 2 2 2 2 3 3 3 3 2 2 1 1 1 
1 1 2 2 2 3 3 3 3 2 2 2 2 1 1 
1 2 2 2 2 2 3 3 3 3 2 2 1 1 1 
1 1 2 2 2 3 3 3 3 2 2 2 2 1 1 
1 2 2 2 2 2 3 3 3 3 2 2 1 1 1 
1 1 2 2 2 3 3 3 3 2 2 2 2 1 1 
1 2 2 2 2 2 7 3 3 3 2 2 1 1 1 
1 1 2 2 2 3 3 3 3 2 2 2 2 1 1 
1 2 2 2 2 2 3 3 6 3 2 2 1 1 1 
1 1 2 2 2 3 3 3 3 2 2 2 2 1 1 
1 2 2 2 2 2 3 3 3 3 2 2 1 1 1 
1 1 2 2 2 3 3 3 3 2 2 2 2 1 1 

67 83 0 0 65 48 78 2 0 0 42 0 0 0 82 
6 7 8 0 66 2 2 2 0 0 2 2 2 2 2 
74 0 0 0 65 0 0 2 0 0 0 72 0 0 0 
0 86 0 0 66 0 0 2 0 0 0 0 0 0 9 
2 2 2 2 2 0 0 2 0 0 0 0 0 0 2 
81 0 48 0 0 0 0 2 0 0 0 0 0 0 80 
6 7 7 8 0 0 2 2 2 0 0 0 2 2 2 
0 70 0 70 0 0 0 2 0 0 69 0 69 0 0 
0 0 0 0 0 0 0 2 0 0 0 0 0 0 0 
77 0 0 0 0 66 0 2 0 65 0 0 0 0 77 
45 45 45 45 45 65 2 2 2 65 45 45 45 45 45 
11 11 11 11 11 66 0 73 0 66 11 11 11 11 11 
2 2 2 2 2 65 0 0 0 65 2 2 2 2 2 
1 1 1 1 1 65 0 87 0 66 1 1 1 1 1 
2 2 2 2 2 2 2 2 2 2 2 2 2 2 2 
