2 2 3 3 2 2 1 1 2 2 3 3 2 2 1 
2 2 3 3 2 2 1 1 2 2 3 3 2 2 1 
2 2 3 3 2 2 1 1 2 2 3 3 2 2 1 
2 2 3 3 2 2 1 1 2 2 3 3 2 2 1 
2 2 3 3 2 2 1 1 2 2 3 3 2 2 1 
2 2 3 3 2 2 1 1 2 2 3 3 2 2 1 
2 2 3 3 2 2 1 1 2 2 3 3 2 2 1 
2 2 3 3 2 2 1 1 2 2 3 3 2 2 1 
2 2 3 3 2 2 1 1 2 2 3 3 2 2 1 
2 2 3 3 2 2 1 1 2 2 3 3 2 2 1 
2 2 3 3 2 2 1 1 2 2 3 3 2 2 1 
2 2 3 3 2 2 1 1 2 2 3 3 2 2 1 
2 2 3 3 2 2 1 1 2 2 3 3 2 2 1 
2 2 3 3 2 2 1 1 2 2 3 3 2 2 1 
2 2 3 3 2 2 1 1 2 2 3 3 2 2 1 

0 72 0 2 0 73 0 2 0 71 0 0 0 0 0 
81 0 0 48 0 0 0 48 0 0 0 0 0 0 0 
2 11 2 2 2 11 2 2 2 11 2 0 0 0 0 
0 0 48 0 0 48 0 0 48 0 0 0 0 0 0 
0 0 6 7 7 7 7 7 8 0 0 0 86 0 0 
0 0 0 0 0 0 0 0 0 6 7 7 7 7 8 
0 0 0 0 0 0 10 0 0 0 0 0 0 0 82 
6 7 7 8 0 6 7 7 7 7 7 7 7 7 8 
0 0 0 0 0 64 0 0 0 0 0 0 0 0 0 
45 45 45 45 45 2 45 45 45 45 2 45 45 45 45 
0 75 0 83 0 2 0 0 0 0 2 74 0 0 83 
45 45 45 2 45 45 45 45 45 45 45 45 45 45 45 
76 83 0 2 73 0 0 0 0 0 0 0 0 0 9 
45 45 45 45 45 45 0 45 0 45 0 45 45 45 45 
11 11 11 11 11 11 11 11 11 11 11 11 11 11 11 
