9 9 9 9 8 8 8 8 9 10 9 8 8 8 9 
9 9 9 9 8 8 8 8 9 10 9 8 8 8 9 
9 9 9 9 8 8 8 8 9 10 9 8 8 8 9 
9 9 9 9 8 8 8 8 9 10 9 8 8 8 9 
9 9 9 9 8 8 8 8 9 10 9 8 8 8 9 
9 9 9 9 8 8 8 8 9 10 9 8 8 8 9 
9 9 9 9 8 8 8 8 9 10 9 8 8 8 9 
9 9 9 9 8 8 8 8 9 10 9 8 8 8 9 
9 9 9 9 8 8 8 8 9 10 9 8 8 8 9 
9 9 9 9 8 8 8 8 9 10 9 8 8 8 9 
9 9 9 9 8 8 8 8 9 10 9 8 8 8 9 
9 9 9 9 8 8 8 12 9 10 9 8 8 8 11 
9 9 9 9 8 8 8 8 9 10 9 8 8 8 9 
9 9 9 9 8 8 8 8 9 10 9 8 8 8 9 
9 9 9 9 8 8 8 8 9 10 9 8 8 8 9 

0 68 0 2 0 0 0 0 0 66 2 2 2 69 67 
0 86 0 0 0 2 2 2 2 65 2 66 48 0 31 
2 2 2 2 0 2 0 72 2 65 2 65 2 2 2 
0 0 0 2 0 2 0 0 2 66 2 66 0 0 0 
82 0 0 1 0 2 73 0 2 65 2 65 0 81 0 
2 2 2 2 0 2 0 0 2 66 2 2 2 2 0 
74 0 0 2 0 0 0 0 9 66 2 70 0 0 0 
0 85 0 1 0 2 0 0 2 65 2 0 83 0 0 
41 2 2 2 0 2 0 0 2 65 2 1 1 1 1 
73 0 0 2 0 2 11 11 2 66 2 70 0 0 0 
0 85 0 1 0 2 2 2 2 66 2 0 0 0 0 
41 2 2 13 0 0 69 0 69 65 2 0 2 2 0 
0 0 0 16 0 0 0 70 0 66 2 0 0 0 0 
0 0 0 16 0 0 0 0 0 65 42 0 0 0 0 
41 2 2 12 2 2 2 2 2 2 2 2 2 2 2 
