2 2 2 2 2 2 2 2 2 2 2 2 2 2 2 
2 2 2 2 2 2 2 2 2 2 2 2 2 2 2 
2 1 2 1 2 1 2 1 2 1 2 1 2 2 2 
1 2 1 2 1 2 1 2 1 2 1 2 1 2 2 
2 1 2 1 2 1 2 1 2 1 2 1 2 2 2 
1 2 1 1 1 2 1 2 1 2 1 2 1 2 2 
2 1 1 2 1 1 2 1 2 1 2 1 2 2 2 
1 1 2 3 2 1 1 2 1 2 1 2 1 2 2 
2 1 1 2 1 1 2 1 2 1 2 1 2 2 2 
1 1 2 3 2 3 2 2 1 2 1 2 1 2 2 
2 1 1 2 1 1 2 1 2 1 2 1 2 2 2 
2 2 2 2 2 2 2 2 2 2 2 2 2 2 2 
2 2 2 2 2 2 2 2 2 2 2 2 2 2 2 
2 2 2 2 2 2 2 2 2 2 2 2 2 2 2 
2 2 2 2 2 2 2 2 2 2 2 2 2 2 2 

74 0 0 0 0 0 0 0 0 0 0 0 0 0 0 
0 3 0 0 0 0 0 0 0 9 0 0 84 65 0 
0 5 1 1 1 1 1 13 2 2 2 2 13 66 2 
0 4 0 0 0 0 0 14 0 0 0 87 16 65 0 
0 4 6 7 7 7 8 12 6 7 7 8 12 65 0 
0 4 0 0 2 0 0 0 0 0 0 0 0 66 0 
0 5 0 0 2 41 0 82 0 2 2 2 2 2 0 
0 4 0 69 0 2 2 1 2 0 73 0 72 0 0 
0 5 0 0 0 0 2 43 2 0 0 0 0 0 0 
0 13 0 69 0 69 0 2 0 0 0 0 0 0 0 
0 15 0 0 0 0 0 0 0 0 0 0 0 0 0 
43 12 13 2 0 0 0 0 0 2 2 2 0 0 0 
2 0 15 70 0 70 0 70 0 70 0 0 2 0 0 
2 31 15 0 0 0 83 0 0 0 0 81 21 2 0 
2 2 12 2 2 2 41 2 2 2 2 2 2 2 43 
