10 10 10 10 10 10 10 10 10 10 10 10 10 10 10 
10 10 10 10 10 10 10 10 10 10 10 10 10 10 10 
9 9 9 9 9 9 9 9 9 9 9 9 9 9 9 
9 9 9 9 9 9 9 9 9 9 9 9 9 9 9 
9 9 9 9 9 9 9 9 9 9 9 9 9 9 9 
8 8 8 8 8 8 8 8 8 8 8 8 8 8 8 
8 8 8 8 8 8 8 8 8 8 8 8 8 8 8 
8 8 8 8 8 8 8 8 8 8 8 8 8 8 8 
8 8 8 8 8 8 8 8 8 8 8 8 8 8 8 
12 8 8 8 8 8 8 8 8 8 8 8 8 8 8 
8 8 8 8 8 8 8 8 8 8 8 8 8 8 8 
9 9 9 9 9 9 9 9 9 9 9 9 9 9 9 
9 9 9 9 9 9 9 9 9 9 9 9 9 9 9 
9 9 9 9 9 9 9 9 9 9 9 9 9 9 11 
9 9 9 9 9 9 9 9 9 9 9 9 9 9 9 

0 0 0 0 0 0 60 0 61 0 0 0 0 0 0 
75 0 74 0 0 0 60 73 61 0 0 0 74 0 75 
0 0 0 0 0 0 60 81 61 0 0 0 0 0 0 
20 45 22 45 45 45 12 2 12 45 45 45 28 45 26 
0 0 0 0 0 0 0 0 0 0 0 0 0 0 0 
11 11 11 11 11 11 11 11 11 11 11 11 11 11 11 
6 7 7 7 7 7 7 7 7 7 7 7 7 7 8 
0 59 0 0 58 15 16 0 14 0 58 15 0 0 82 
0 2 2 2 2 2 2 2 2 2 2 2 2 2 2 
0 15 0 14 0 0 59 0 0 58 0 17 0 14 9 
2 2 1 1 1 2 2 1 1 2 1 1 1 2 2 
0 0 0 1 0 0 1 0 0 0 1 0 0 0 0 
0 0 0 1 0 84 1 0 84 0 1 1 0 0 0 
0 0 0 1 0 0 1 0 0 0 1 0 0 0 0 
2 2 1 1 1 2 2 1 1 2 1 1 1 2 2 
